9 6
7 7 7 7 0 3 0 6 6
 7 7 7 0 0 0 0 6 6
7 7 0 0 0 0 8 0 0
 0 5 0 0 0 0 0 0 0
0 0 0 0 0 8 0 0 0
 8 0 0 0 0 0 0 4 4