15 10
6 6 6 0 0 0 5 0 0 0 7 7 7 7 7
 6 0 0 0 7 0 0 0 7 0 0 7 7 7 7
6 0 0 5 0 0 0 6 6 0 0 0 7 7 7
 6 0 0 0 0 0 0 0 6 0 0 0 0 7 7
0 0 8 0 0 0 5 0 0 0 0 0 0 0 0
 0 0 0 0 8 8 0 0 0 7 0 0 5 0 0
0 0 0 0 0 0 8 0 0 0 0 8 0 0 6
 4 0 0 0 0 0 0 0 0 0 0 8 0 0 6
0 0 0 0 0 0 0 0 0 0 0 0 0 6 6
 4 0 4 0 0 0 0 0 0 3 0 6 6 6 6